++++++++++++++ 
+   + + + +  + 
+ +++      + + 
+ + + ++++++ + 
+ +   + +    + 
+ + + + +++ ++ 
+ + +++  +   + 
+   + + +    + 
+ + +   + + ++ 
+S+ + + + +  + 
+ +   +   ++ + 
+++++++++  + + 
+ + + + + ++++ 
+   + + + +  + 
+ +++      + + 
+ + + ++++++ + 
+ +   + +    + 
+ + + + +++ ++ 
+ + +++  +   + 
+   + + +    + 
+ + +   + + ++ 
+ + + + + +  + 
+ +   +   ++   
++++++++++++++ 