++++++++++++++++++++++++ 
+ +    +++++++        ++ 
+ + +++ +    + ++++++ ++ 
+       + ++ +  +++++ ++ 
+ ++ ++ + +  ++ +++++ ++ 
++    +   +  +    +++ ++ 
+ +   + + +  + ++ +++ ++ 
+   +  +  +  + +  +++ ++ 
+ +  ++  ++  + + ++++ ++ 
+ +  +  + + ++ +    + ++ 
+ ++++  +   +   +++  +++ 
+    +  +   + ++++++  ++ 
++ +++  +  +  +  ++++  + 
+    +  +            + + 
+ ++ +  +++++    ++++  + 
+ +  +       +++++       
+S+ +            +     + 
++++++++++++++++++++++++ 