++++++++++++++ 
+   +   +      
+ + + + + + ++ 
+ + + + + + ++ 
+ + + + + + ++ 
+ + + + + + ++ 
+ + + + + + ++ 
+ +   +   +  + 
+ ++++++++++++ 
+            + 
++++++++++++ + 
+S           + 
++++++++++++++ 