XXXXXXX
X   XXX
X X  XX
X XX  X
X  XX X
XX X  X
X  X  X
XXXXX X
XX XX X
X  X  X
XX X XX
XX X  X
X    XX
X XXXXX
X X   X
X X X X
X   X X
X X   X
XXXXX X
X   X X
X X X X
X XXX X
X   X X
X X   X
XS  X X
XXXXXXX