XXXXXXX
X   XXX
X X  XX
X XX   
X  XXXX
XX X  X
X  X  X
X XXX X
XSX X X
X     X
XXXXXXX