XXXXXXXXXXXXXX
X   X   X    X
X X X X X X XX
X X X X X X XX
X X X X X X XX
X X X X X X XX
X X X X X X XX
X X   X   X  X
X XXXXXXXXXXXX
X            X
XXXXXXXXXXXX X
XS           X
XXXXXXXXXXXXXX