XXXXXXX
X   X X
X X X x
X X X X
X X   X
X X X X
X XXX X
X   X X
X X X  
XxX X X
X X   X
XSX XXX
X X X X
X   X X
X X X x
X X X X
X X   X
XxXXXXX