XXXXXXX
X X X X
X X    
X X X X
X X X X
X X X X
X X X X
X   X X
X X X X
X X X X
XSX X X
XXXXXXX